0000000000
0000000000
0011110000
0010010113
2110010100
0000010100
0000011100
0000000000
0000000000
0000000000