0000000000
2110000000
0010111100
0010100100
0011100100
0000000100
0111111100
0100000000
0111111113
0000000000