0011111100
0010000100
0011000100
0001000100
2111001113
0001001000
0001111000
0000000000
0000000000
0000000000